NO resources/stone.xpm
SO resources/coal.xpm
WE resources/brickov.xpm
EA resources/walkstone.xpm

F 74,171,0
C 37,150,190

111111111111111111111111
100000000000000000000001
100000000000000000000001
100000000000000000000001
100000111110000101010001
100000100010000000000001
100000100010000100010001
100000100010000000000001
100000110110000101010001
100000000000000000000001
100000000000000000000001
100000000000000000000001
100000000000000000000001
100000000000000000000001
100000000000000000000001
100000000000000000000001
111111111000000000000001
110100001000000000N00001
110000101000000000000001
110100001000011111111111
110111111000000000000001
110000000000000000000001
111111111000000000000001
111111111111111111111111
