F 80,84,92
C 117,164,240

NO ./resources/stone.xpm
SO ./resources/coal.xpm
WE ./resources/brickov.xpm
EA ./resources/walkstone.xpm


11111111111111111111
10000000000001000001
10000000N00000000001
10000000000010000001
10000000000010000001
11111111111111111111
