F 210,100,0
C          215,30,0

NO ./Makefile
SO ./Makefile
WE ./Makefile
EA ./Makefile

 1
1
 111111
 100001
 1111111
1000011  11 1
10N000111111111
 11111
