NO resources/brickov.xpm
SO resources/brickov.xpm
WE resources/brickov.xpm
EA resources/brickov.xpm


C 252,253,123456465897897894564231321234567894564123
F 252,253,255

1111111111
1000000001
100N000001
1000000001
1111111111
